{
    "width": 28,
    "height": 17,
    "tileSize": 32,
    "tileData": [
        0,0,0,0,0,0,0,0,0,0,0,0,0,0,0,0,0,0,0,0,0,0,0,0,0,0,0,0,
        0,0,0,0,0,0,0,0,0,0,0,0,0,0,0,0,0,0,0,0,0,0,0,0,0,0,0,0,
        0,0,0,0,0,0,0,0,0,0,0,0,0,0,0,0,0,0,0,0,0,0,0,0,0,0,0,0,
        0,0,0,1,1,1,0,0,0,1,1,1,0,0,0,1,1,1,0,0,0,1,1,1,0,0,0,0,
        0,0,0,0,0,0,0,0,0,0,0,0,0,0,0,0,0,0,0,0,0,0,0,0,0,0,0,0,
        0,0,0,0,0,0,0,0,0,0,0,0,0,0,0,0,0,0,0,0,0,0,0,0,0,0,0,0,
        0,0,0,0,0,0,0,0,0,0,0,0,0,0,0,0,0,0,0,0,0,0,0,0,0,0,0,0,
        0,0,0,0,0,0,0,0,0,0,0,0,0,0,0,0,0,0,0,0,0,0,0,0,0,0,0,0,
        0,0,0,0,0,0,0,0,0,0,0,0,0,0,0,0,0,0,0,0,0,0,0,0,0,0,0,0,
        0,0,0,0,0,0,0,0,0,0,0,0,0,0,0,0,0,0,0,0,0,0,0,0,0,0,0,0,
        0,1,1,1,0,0,0,1,1,1,0,0,0,1,1,1,0,0,0,1,1,1,0,0,0,1,1,0,
        0,0,0,0,0,0,0,0,0,0,0,0,0,0,0,0,0,0,0,0,0,0,0,0,0,0,0,0,
        1,1,1,1,1,1,1,1,1,1,1,1,1,1,1,1,1,1,1,1,1,1,1,1,1,1,1,1,
        0,0,0,0,0,0,0,0,0,0,0,0,0,0,0,0,0,0,0,0,0,0,0,0,0,0,0,0,
        1,1,1,1,1,1,1,1,1,1,1,1,1,1,1,1,1,1,1,1,1,1,1,1,1,1,1,1,
        1,1,1,1,1,1,1,1,1,1,1,1,1,1,1,1,1,1,1,1,1,1,1,1,1,1,1,1,
        1,1,1,1,1,1,1,1,1,1,1,1,1,1,1,1,1,1,1,1,1,1,1,1,1,1,1,1
    ],
    "entities": [
        { "type": "player", "x": 64, "y": 320 },
        { "type": "enemy", "x": 150, "y": 256, "speed": 160 },
        { "type": "enemy", "x": 350, "y": 96, "speed": 140 },
        { "type": "enemy", "x": 550, "y": 256, "speed": 180 },
        { "type": "enemy", "x": 750, "y": 96, "speed": 120 },
        { "type": "goal", "x": 832, "y": 256 }
    ],
    "movingPlatforms": [
        { "x": 120, "y": 240, "width": 64, "height": 16, "endX": 200, "endY": 240, "speed": 180 },
        { "x": 280, "y": 160, "width": 64, "height": 16, "endX": 360, "endY": 160, "speed": 200 },
        { "x": 480, "y": 240, "width": 64, "height": 16, "endX": 560, "endY": 240, "speed": 170 },
        { "x": 680, "y": 160, "width": 64, "height": 16, "endX": 760, "endY": 160, "speed": 190 }
    ]
}